24 14
000000000000000000000000
007000000000000000000100
000700000000000000002100
000060000000000000032000
000005000000000000430000
000000400000000001100000
000000033000000025000000
000000000220000000000000
000000000001000000000000
000000000000800000000000
000000000022001000000000
000000000330000200000000
000000004400000023000000
000000000000000000000000