24 14
000000000000000000000000
000000000000000000000000
002200000000000000002200
010000200000000002000010
100000333333333333000001
100000000000000000000001
050000000000000000000050
000040000000000000040000
000004000000000000400000
000000400000000004000000
000000000666666000000000
000000000000800000000000
000000000000000000000000
000000000000000000000000