24 14
000000000000000000000000
000000000000000000000000
001100000000000000011000
002200000000000000022000
001100989009000900091000
002200000000000000029000
000000000000000000000000
000000000000000000000000
003456000000000000000000
000000000000000000000000
000000000789000000000000
000000000000000000000000
000000000000000000000000
000000000000000000000000